STRINGS
AlignBottom	Align Bottom
AlignHorizontal	Align Horizontal
AlignLeft	Align Left
AlignRight	Align Right
AlignTop	Align Top
AlignVertical	Align Vertical
BorderChange	Border Change
ChangeZOrder	Change Z Order
CntrlInstallFailed	form controller installation failed
ForceToGrid	Force to Grid
Globals	Globals
GridChange	Grid Change
InsertAround	Insert Around
ModuleNotFound	module ^0 not found
SetEnabled	Set Enabled
SetName	Set Name
VariableNoRecord	variable ^0 is not a record or NIL pointer
VariableNotFound	variable ^0 not found
VariableNotFoundIn	variable ^0 not found in ^1
FormViews.StdViewDesc	standard Form view
FormModels.StdModelDesc	standard Form model
FormControllers.StdControllerDesc	standard Form controller
