STRINGS
Shift	Shift+
Ctrl	Ctrl+
Space	Space
Edit	&Edit
Open	&Open
MoveHere	&Move Here
CopyHere	&Copy Here
LinkHere	&Link Here
Object	&Object
MissingDirectory	Missing Directory
CreateDir	The directory ^0 will be created
FileError	File Error
ReplaceWriteProtected	^0 could not be replaced^1because it is write protected
ReplaceInUse	^0 could not be replaced^1because it is in use
ReplaceAccessDenied	^0 could not be replaced^1because access is denied
AllocatedMemory	 Allocated Memory: 
Total	    Total: 
Bytes	 Bytes
Print	Print
OpenFile	Open
ControlInspector	Control Inspector
SaveChanges	^0 has changed.^1^2Do you want to save the changes?
Saving	saving
Saved	saved
Failed	failed
Document	Document
AllFiles	All Files
NotUnderWindows3	Feature not available under Windows 3.11

HostTextConv.ImportText	Text
HostTextConv.ImportTabText	Text (space pairs as tabs)
HostTextConv.ImportRichText	Rich Text
HostTextConv.ImportUnicode	Unicode Text
HostTextConv.ImportHex	Data File (hex)
HostTextConv.ImportDosText	Text (Dos encoding)
HostBitmaps.ImportBitmap	Bitmap
HostBitmaps.ExportBitmap	Bitmap

HostTextConv.ExportText	Plain Text
HostTextConv.ExportTabText	Plain Text (tabs as space pairs)
HostTextConv.ExportRichText	Rich Text
HostTextConv.ExportUnicode	Unicode Text
HostBitmaps.ExportBitmap	Bitmap

HostTextConv.ImportDRichText	Rich Text
HostTextConv.ImportDUnicode	Unicode Text
HostTextConv.ImportDText	Plain Text
HostPictures.ImportDPict	Picture (Metafile)
HostBitmaps.ImportDBitmap	Picture (Bitmap)
HostBitmaps.ImportDPictAsBitmap	Picture (Bitmap)

TextViews.StdView	text
HostPictures.StdView	a picture
HostBitmaps.StdView	a bitmap picture

Properties.StdProp	HostDialog.FontDialog

Bitmaps.Evaluate.101	Not enough memory to allocate bitmap
